R R R R R R R R R X R R R R R R R X R X R
X X X X X X T X R X R X X X X X X X R X R
K R R R R R R X R R R X R R R R R R R X R
X X X X R X R X X X X X X X R X X X R X R
R R R R R X R R R R R X R R R R R X R X R
R X R X R X X X X X X X R X X X R X X X R
R R R X R X R X T R X R R X R X R X R R R
R X X X R X R X R X X X X X R X R X R X X
R X R R R R R X R X R X R R R R R R R X R
R X R X X X X X R X R X R X R X X X R X R
R X R X R R R R R R R X R X R R R X R X R
X X R X R X X X X X R X R X X X R X X X R
R R R X T X R R R X R X R X R X R R R R R
R X R X R X X X R X X X R X R X X X X X X
R X R X R R R X R X R R R R R X R R R R R
R X R X X X R X R X R X X X X X R X X X R
R X R R R R R X R X R X R X R R R X R R R
R X R X X X X X R X R X R X R X X X X X X
R X R X R R R X R R R X R R R R R R R R R
R X R X R X X X X X X R X X X R X R X X X
R X R R R X R R R R R R R R R X R R R R R