R R R T R R R T R T R R
T X X T T X X T X X T R
X R R X X R X X R T X R
R R R R R R R R X X T T
T X X X X T X R X X R R
R R R R T K T X R R R R
R R X X X T X X T X X R
T X R R R R X T T T R X
T X X T X R R X R X R X
R R R R X R R T R X R T